 1111111111111       11111 1111             
111     100001       10001 1001             
1011111110000111111111000111001111          
11110000000000000000000001 1000001          
 1110000000000000N00000001110000011111111111
11110000000001111100000000000000010000000001
11111000000001   100000000000000000111111111
    1111111111   1111111111111111111         
