NO ./path_to_the_north_texture
SO ./path_to_the_south_texture
WE ./path_to_the_west_texture
EA ./path_to_the_east_texture
F 120,100,0
C 225,30,0

        1111111111111111111111111
        1000000000110000000000001
        1011000001110000000000001
        1001000000000000000000001
111111111011000001110000000000001
100000000011000001110111111111111
11110111111111011100000010001
11110111111111011101010010001                                                        1111
11000000110101011100000010001                                                        10N1
10000000000000001100000000001                                                        1111
10000000000000000001010010001
110000011101010111110111100111111111111
11110111 1110101 1000110100000000000001
11111111 1111111 1111111111111111111111
